Ipê-amarelo - Handroanthus albus
Aroeira - Schinus terebinthifolius
Pau-brasil - Paubrasilia echinata
Jacarandá - Jacaranda mimosifolia
Copaíba - Copaifera langsdorffii
Jatobá - Hymenaea courbaril
Cajú - Anacardium occidentale
Castanheira-do-Pará - Bertholletia excelsa
Sucupira - Bowdichia virgilioides
Embaúba - Cecropia pachystachya
Pitangueira - Eugenia uniflora
Pau-ferro - Libidibia ferrea
Paineira - Ceiba speciosa
Mangueira - Mangifera indica
Guapuruvu - Schizolobium parahyba
Angico - Anadenanthera colubrina
Ipê-roxo - Handroanthus impetiginosus
Sibipiruna - Caesalpinia peltophoroides
Cedro - Cedrela fissilis
Jequitibá-rosa - Cariniana legalis
Acácia - Acacia mangium
Araucária - Araucaria angustifolia
Buriti - Mauritia flexuosa
Caviúna - Dalbergia nigra
Eucalipto - Eucalyptus globulus
Figueira - Ficus insipida
Ingá - Inga edulis
Jenipapo - Genipa americana
Louro-pardo - Cordia trichotoma
Maracujá - Passiflora edulis
Mogno - Swietenia macrophylla
Murici - Byrsonima crassifolia
Pitangueira - Eugenia uniflora
Pitombeira - Talisia esculenta
Quaresmeira - Tibouchina granulosa
Sapucaia - Lecythis pisonis
Tucaneiro - Caryocar brasiliense
Umbuzeiro - Spondias tuberosa
Vitória-régia - Victoria amazonica
Jamelão - Syzygium cumini
Ipê-branco - Tabebuia roseoalba
Mutambo - Guazuma ulmifolia
Seringueira - Hevea brasiliensis
Tarumã - Vitex montevidensis
Canafístula - Peltophorum dubium
Caviúna - Dalbergia nigra
Guabiroba - Campomanesia xanthocarpa
Oiticica - Licania rigida
